2 13 31
###############################
#p     **     1 *2 *  * * *   #
# # #*#*# # #*#*# # # #*#***# #
#  x*     ***  *  1   * 2 * * #
# #   # # #*# #  *#*# # # # #*#
#f     x   x **  *  *   1     #
# # #   #   # # # #*  #*# # # #
#*  *      *  *  *   *    2   #
# # # * #*# # **#*#*# * # # # #
#*        *         #         #
##  * ### #   #s*#  #  ##  ** #
#  o **  *  1     *        o  #
###############################
