2 13 31
###############################
#p     **     1 *2 * o* * *   #
#*# ****# * #*#*# # # #*#***# #
#  **     ***  *  1   *   * * #
# # 1 # # **# #  *#*# # # # #*#
#f     *   x **  *  *         #
# # #   #   # # # #*  #*# # # #
#*  *   s  o  *  *   *    2   #
# # # # #*# # **#*x*# * # # # #
#*        *                   #
# # # ###  ** #s*#   o ##  ** #
#    **  *  1     *b          #
###############################
